NO /app/assets/textures/birds_tex_e.xpm
SO /app/assets/textures/birds_tex_n.xpm
WE /app/assets/textures/birds_tex_s.xpm
EA /app/assets/textures/birds_tex_w.xpm


F 230,100,0
C 240,100,0

111111111
1S0000001
111111111

