NO /home/carlaugu/42-Carlos/42Common_Core/Rank4/42-cub3d/assets/textures/birds_tex_n.xpm
SO /home/carlaugu/42-Carlos/42Common_Core/Rank4/42-cub3d/assets/textures/birds_tex_s.xpm
WE /home/carlaugu/42-Carlos/42Common_Core/Rank4/42-cub3d/assets/textures/birds_tex_e.xpm
EA /home/carlaugu/42-Carlos/42Common_Core/Rank4/42-cub3d/assets/textures/birds_tex_w.xpm


F 212,100,0
C 240,100,0


1111
10N1
11111