NO ./assets/textures/pikachu_tex_s.xpm
SO ./assets/textures/pikachu_tex_n.xpm
WE ./assets/textures/pikachu_tex_e.xpm
EA ./assets/textures/pikachu_tex_w.xpm

F 98,209,131
C 120,240,228

111111111111111111111111
100000000001000010000001
100010000000000000000001
100011111111111111111111
1000000000000000000001
1111111111111111110001
10001  10000010000001
100011111100000000001
100000000000000001111
111111000000000101
     1000000000101111
111111000000000100001
10000000000N000101111
101010101111000101
10000000000111110011111
100000000000000000000001
111111111111111111111111