NO ./assets/textures/pikachu_tex_n.xpm
SO ./assets/textures/pikachu_tex_s.xpm
WE ./assets/textures/pikachu_tex_w.xpm
EA ./assets/textures/pikachu_tex_e.xpm

F 98,209,131
C 120,240,228

     11111      1111111111111
    100001      1000000000001
   100001       1001111000001
  1000001 1111  111   1000001
 1000000010001   1   1000001
 1000000E00001      1000001
 1111111110001     1000001
         10001    1000001  1
         10001111100000011101
         10000000000000000001
         11111111111111111111






