NO ./assets/textures/wolfenstein_tex_n.xpm
SO ./assets/textures/wolfenstein_tex_s.xpm
WE ./assets/textures/wolfenstein_tex_w.xpm
EA ./assets/textures/wolfenstein_tex_e.xpm

F 0,0,255
C 0,255,255

    111111111111   1111111111111111
    1000000000011111000000000000001
    1000000000000010000000000000001
    1011110111111010111110111111101
    1010000100000010000010100000101
    1010111101111110111010111110101
11111001011101111110001010101011111
1010000101000000001010000010101
1011110101011111101110111010101
1000000101000000100000100010101
1111111101110111111111111010101
1000000000000100000000000010101
1011111111110101111111111010111
1010000000010001000000010010001
1111111111111011111111111111101
1010000010000000000010000000111
1011111010111111111010111111101
10000000100000000000000000000N1
1111111111111111111111111111111