NO ./assets/textures/pikachu_tex_n.xpm
SO ./assets/textures/pikachu_tex_s.xpm
WE ./assets/textures/pikachu_tex_w.xpm
EA ./assets/textures/pikachu_tex_e.xpm

F 98,209,131
C 120,240,228

111111
10N001
111111






