NO ./assets/textures/wolfenstein_tex_n.xpm
SO ./assets/textures/wolfenstein_tex_s.xpm
WE ./assets/textures/wolfenstein_tex_w.xpm
EA ./assets/textures/wolfenstein_tex_e.xpm

C 255,255,1             
F 0,0,0

111111
10N001
111111






