NO ./assets/textures/pikachu_tex_n.xpm
SO ./assets/textures/pikachu_tex_s.xpm
WE ./assets/textures/pikachu_tex_w.xpm
EA ./assets/textures/pikachu_tex_e.xpm

F 98,209,131
C 120,240,228

11111111111111111111111111111
10000000000000000000000000001
100000E0000000000000000000001
10000000000000000000000000001
10000000000000000000000000001
10000000000000000000000000001
10000111100000000000000000001
100001  100000000000000000001
100001  100000000000000000001
100001  100000000000000000001
111111  111111111111111111111
         
            
              