NO ./assets/textures/pikachu_tex_n.xpm
SO ./assets/textures/pikachu_tex_s.xpm
WE ./assets/textures/pikachu_tex_w.xpm
EA ./assets/textures/pikachu_tex_e.xpm

F 98,209,131
C 120,240,228

11111111111111111111111111111
10000000000000000000000000001
100000N0000000000000000000001         1111111111111
10000000000000000000000000001         10000000000001
10000000000000000000000000001         11111111111111          
10000000000000000000000000001
10000000000000000000000000001
10000000000000000000000000001
1000000000000000000000000001
10000000000000000000000000001
11111111111111111111111111111