NO ./assets/textures/birds_tex_n.xpm
SO ./assets/textures/birds_tex_s.xpm
WE ./assets/textures/birds_tex_w.xpm
EA ./assets/textures/birds_tex_e.xpm

F 220,100,0
C 225,30,0

11111111111111111111111111111
10000000000000000000000000001
100000N0000000000000000000001
10000000000000000000000000001
10000000000000000000000000001
10000000000000000000000000001
10000111100000000000000000001
100001  100000000000000000001
100001  100000000000000000001
100001  100000000000000000001
111111  111111111111111111111