NO ./assets/textures/wolfenstein_tex_n.xpm
SO ./assets/textures/wolfenstein_tex_s.xpm
WE ./assets/textures/wolfenstein_tex_w.xpm
EA ./assets/textures/wolfenstein_tex_e.xpm

C 0,255,255
F 0,0,255
F 0,0,255

111111111111111111111111
100000000000000000000001
100000000000000000000001
100000000000000000000001
100000000000000000000001
100000000000000000000001
100000000011111000000001
100000000000001000000001
100000000010001000000001
100000000000001000000001
100000000010001000000001
100000000000001000000001
1000000000100010000000W1
100000000000001000000001
100000000011011000000001
100000000000000000000001
100000000000000000000001
100000000000000000000001
100000000000000000000001
100000000000000000000001
100000000000000000000001
100000000000000000000001
100000000000000000000001
111111111111111111111111