NO ./assets/textures/wolfenstein_tex_n.xpm
SO ./assets/textures/wolfenstein_tex_s.xpm
WE ./assets/textures/wolfenstein_tex_w.xpm
EA ./assets/textures/wolfenstein_tex_e.xpm

F 0,0,255
C 0,255,255

11111111111111111111111111111
10000000000000000000000000001
10000000000000000000000000001
100000000N1111100000000000001
1000000001    100000000000001
10000000011111100000000000001
10000000000000000000000000001
10000000000000000000000000001
10000000000000000000000000001
10000000000000000000000000001
11111111111111111111111111111