NO ./assets/textures/birds_tex_n.xpm
SO ./assets/textures/birds_tex_s.xpm
WE ./assets/textures/birds_tex_w.xpm
EA ./assets/textures/birds_tex_e.xpm

F 220,100,0
C 225,30,0

11111111111111111111111111111
10000000000000000000000000001
100000N0000000000000000000001
10000000011111100000000000001
1000000001    100000000000001
10000000011111100000000000001
10000000000000000000000000001
10000000000000000000000000001
10000000000000000000000000001
10000000000000000000000000001
11111111111111111111111111111