NO ./assets/textures/birds_tex_n.xpm
SO ./assets/textures/birds_tex_s.xpm
WE ./assets/textures/birds_tex_w.xpm
EA ./assets/textures/birds_tex_e.xpm

F 220,100,0
C 225,30,0

1111111111111111111111111111111111111111111111111111111111
1000000000000000000000000000111111111111111111111111111111
100000N000000000000000000000000000000000000000000000000001
1000000000000000000000000000111111111111111111111111111111
1000000000000000000000000000111111111111111111111111111111
1000000000000000000000000000111111111111111111111111111111
1000000000000000000000000000111111111111111111111111111111
1000000000000000000000000000111111111111111111111111111111
1000000000000000000000000000111111111111111111111111111111
1000000000000000000000000000111111111111111111111111111111
11111111111111111111111111111