NO ./assets/textures/birds_tex_n.xpm
SO ./assets/textures/birds_tex_s.xpm
WE ./assets/textures/birds_tex_w.xpm
EA ./assets/textures/birds_tex_e.xpm

F 220,100,0
C 225,30,0

1111111111111
10A0000000001
1000000000001
1111111111111