NO ./assets/textures/wolfenstein_tex_n.xpm
SO ./assets/textures/wolfenstein_tex_s.xpm
WE ./assets/textures/wolfenstein_tex_w.xpm
EA ./assets/textures/wolfenstein_tex_e.xpm

F 220,100,0
C 225,30,0

1111111
10N0001
10001
1111111