NO ./assets/textures/pikachu_tex_n.xpm
SO ./assets/textures/pikachu_tex_s.xpm
WE ./assets/textures/pikachu_tex_w.xpm
EA ./assets/textures/pikachu_tex_e.xpm

C 120,240,228
F 98,209,131

111111111111111111111111111111111111
000000000000000000000000000000000001
100000000000000000N00000000000000001
111111111111111111111111111111111111