NO ./assets/textures/pikachu_tex_n.xpm
SO ./assets/textures/pikachu_tex_s.xpm
WE ./assets/textures/pikachu_tex_w.xpm
EA ./assets/textures/pikachu_tex_e.xpm

C 120,240,228
F 98,209,131

1111111111111
1000000000001
1000000000001
10N         1
1111111111111